


NO textures/north.xpm
WE textures/west.xpm
SO textures/south.xpm
EA textures/east.xpm

F 167,19,255
C 60,59,59

1111111
1000001
101W001
1000001
1111111