


NO textures/north.xpm
WE textures/west.xpm
SO textures/south.xpm
EA textures/east.xpm

F 27, 44, 34
C 11,26,22


111111111111111
100000000100001
101100000101001
10010000010E101
101011110011101
100000000000001
111111111111111