NO   textures/north.xpm

WE textures/west.xpm


C 120,0,16

F 3,4,50


 SO  textures/south.xpm
EA  textures/east.xpm


    11111111111111111111111111 
    110000100000001111111111
    1000100000000011
 111100000000001111111
1000000000E00000000011111
 1000000000000011111111
 100000000010001
100000011000001
11111111111111