NO   textures/north.xpm

WE textures/west.xpm


C 120,0,16

F 3,4,50


 SO  textures/south.xpm
EA  textures/east.xpm


 1        1  1    1
  1 1  1  1
 111111111111111111111110
 0111110000000000000111111110
1100001000000011111111110
1000100000000010
100100000000001111111
10000000000000000000011111
1000000000000011111111
100000000010001
100000011000001
1111     11 1111111