NO   textures/north.xpm 

WE textures/west.xpm 


C 120,0,16  

F 3,4,50


 SO  textures/south.xpm 
EA  textures/east.xpm 



 11111111111111111111111
100000000000001111111
1000001000000011111111111
100010000000001
100100000000001111111
10000000000000000000011111
1000000000000011111111
100000000010001
100000011000001
1111111 1111111