NO   textures/north.xpm
WE textures/west.xpm
SO  textures/south.xpm
EA  textures/east.xpm
C 120,0,16
F 3,4,50


111111111111111111111111111
   10000000000000000011
  010000000000000000001
 1000000000000000000011111
100000000000000000000000001
111111111111111111111111111
