   
   
   
    NO   textures/north.xpm 

WE textures/west.xpm   



F 5, 50, 120
SO  textures/south.xpm    
EA  textures/east.xpm
C 120,0,16

    11111111111111111111111
    10000000000000111111111111
    1000001000000011111111111
    100010000000001
1111100100000000001111111
100000000000N000000001
1000000000000011111111
100000000010001
100000011000001
1111111 1111111