NO img/NORTH.xpm
WE img/WEST.xpm
F 1, 2,0
SO img/SOUTH.xpm
EA img/EAST.xpm
C 120,0,16

111111111111111
100000000000001
100000100000001
100010000000001
100100000000001
100000000000001
100000000000001
100000000010001
100000011000001
1111111  1111111
