NO   textures/north.xpm 

WE textures/west.xpm   



F , 50, 120
 SO  textures/south.xpm    
EA  textures/east.xpm
C 120,0,16

111111111111111
100000000000001
100000100000001
100010000000001
100100000000001
100000000000001
100000000000001
100000000010001
100000011000001
1111111 1111111
