NO img/MARBFAC2.xpm
WE img/SKULWALL.xpm
SE img/MARBFACE.xpm
EA img/SKULWAL3.xpm

F 0,32,0
C 120,0,16

        1111111111111111111111111
        1000000000110000000000001
        1011000001110000000000001
        1001000000000000000000001
111111111011000001110000000000001
100000000011000001110111110111111
11110111111111011100000010001
11110111111111011101010010001
11000000110101011100000000001
10000000000000001100000010001
10000000000000001101010010001
11000001110101011111011110N0111
11110111 1110101 101111010001
11111111 1111111 111111111111
