NO     textures/north.xpm
C        120,       0   ,16
WE   textures/west.xpm


SO   textures/south.xpm
F  0,        32, 0
EA          textures/east.xpm

    111111111111111111111111111111111111111111111111111111
    10000000000000000000000S000000000000000000000000000001
    100000000000000000000000000000000000000000000000000001
    111111111111111111111111111111111111111111111111111111
