NO img/MARBFAC2.xpm

WE img/SKULWALL.xpm

SO img/MARBFACE.xpm




EA img/SKULWAL3.xpm

F 0,32,0
C 120,0,16







111111111111111
100000000000001
100010000000001
100100000000001
100000000000001
100000000000001
111111111111111
