NO img/MARBFAC2.xpm

WE img/SKULWALL.xpm

SO img/MARBFACE.xpm




EA img/SKULWAL3.xpm

F 0,32,0
C 120,0,16







1111111
1000001
1000001
1111111
