NO textures/north.xpm
WE textures/west.xpm
SO textures/south.xpm
EA  textures/east.xpm
F 0,32,0
C 120,0,16


        1
       101
      10001
     1000001
11111000000011111
   10000000001
    100000001
     1000001
      10001
       101
        1