NO   textures/north.xpm
WE textures/west.xpm
SO  textures/south.xpm
EA  textures/east.xpm

F       0    ,  32,0
C           120, 0    ,  16
	1       1       1
	1 1     1 1     1 1
	1   1   1   1   1   1
	1     1 1     1 1     1
	1      1       1      1
	11111111111111111111111
	10000000000000000000001
	1000011000S000011000001
	10000110000000011000001
	10000000001110000000001
	10000000000000000000001
	 111111111111111111111
